1111111111111111111111111111111111
1EP000000000000C00B00C000000000001
1111111111111111111111111111111111
