1111111111111111111111111111111111
1EP000000000000C00100C000000000001
1111111111111111111111111111111111
