1111111111111111111111111111111111
1E10P0000000000C00000C000000000001
1111111111111111111111111111111111
