1111111111111111111111111111111111
1EP000000000000C00000C000000000001
1111111111111111111111111111111111
